TTTTTTTT
T      T
T      T
T      T
.      T
T      T
T      T
T      T
TTTTTTTT