RRRRRRRR
R      R
R      T
R      .
R      .
R      .
R      T
R      R
RRRRRRRR
